7
0, 2, 4, 2, 6, 9, -1
2, 0, 5, 4, 2, -1, 3
4, 5, 0, -1, 3, 2, 1
2, 4, -1, 0, 9, 7, 5
6, 2, 3, 9, 0, 2, 1
9, -1, 2, 7, 2, 0, 8
-1, 3, 1, 5, 1, 8, 0